"filename", "language", "Markdown", "TypeScript", "YAML", "JSON", "JSON with Comments", "comment", "blank", "total"
"d:\Projects\truth-mesh\.github\FUNDING.yml", "YAML", 0, 0, 0, 0, 0, 0, 1, 1
"d:\Projects\truth-mesh\ARCHITECTURE.md", "Markdown", 560, 0, 0, 0, 0, 0, 127, 687
"d:\Projects\truth-mesh\CONTRIBUTING.md", "Markdown", 248, 0, 0, 0, 0, 0, 112, 360
"d:\Projects\truth-mesh\GROK_RESPONSES.md", "Markdown", 51, 0, 0, 0, 0, 0, 28, 79
"d:\Projects\truth-mesh\MANIFESTO.md", "Markdown", 323, 0, 0, 0, 0, 0, 140, 463
"d:\Projects\truth-mesh\README.md", "Markdown", 127, 0, 0, 0, 0, 0, 67, 194
"d:\Projects\truth-mesh\ROADMAP.md", "Markdown", 252, 0, 0, 0, 0, 0, 96, 348
"d:\Projects\truth-mesh\docs\bias-tags-system.md", "Markdown", 0, 0, 0, 0, 0, 0, 1, 1
"d:\Projects\truth-mesh\docs\challenge-portals.md", "Markdown", 0, 0, 0, 0, 0, 0, 1, 1
"d:\Projects\truth-mesh\docs\core-facts-layer.md", "Markdown", 267, 0, 0, 0, 0, 0, 99, 366
"d:\Projects\truth-mesh\docs\provenance-tracking.md", "Markdown", 0, 0, 0, 0, 0, 0, 1, 1
"d:\Projects\truth-mesh\examples\use-cases.md", "Markdown", 143, 0, 0, 0, 0, 0, 62, 205
"d:\Projects\truth-mesh\package.json", "JSON", 0, 0, 0, 64, 0, 0, 1, 65
"d:\Projects\truth-mesh\packages\core\README.md", "Markdown", 121, 0, 0, 0, 0, 0, 42, 163
"d:\Projects\truth-mesh\packages\core\examples\basic-usage.ts", "TypeScript", 0, 58, 0, 0, 0, 26, 12, 96
"d:\Projects\truth-mesh\packages\core\examples\batch-operations.ts", "TypeScript", 0, 102, 0, 0, 0, 29, 18, 149
"d:\Projects\truth-mesh\packages\core\examples\custom-config.ts", "TypeScript", 0, 143, 0, 0, 0, 47, 51, 241
"d:\Projects\truth-mesh\packages\core\mnt\user-data\outputs\src\types\index.ts", "TypeScript", 0, 21, 0, 0, 0, 12, 4, 37
"d:\Projects\truth-mesh\packages\core\package-lock.json", "JSON", 0, 0, 0, 10103, 0, 0, 1, 10104
"d:\Projects\truth-mesh\packages\core\package.json", "JSON", 0, 0, 0, 64, 0, 0, 1, 65
"d:\Projects\truth-mesh\packages\core\src\config.ts", "TypeScript", 0, 41, 0, 0, 0, 43, 11, 95
"d:\Projects\truth-mesh\packages\core\src\crypto\signatures.ts", "TypeScript", 0, 59, 0, 0, 0, 52, 14, 125
"d:\Projects\truth-mesh\packages\core\src\index.ts", "TypeScript", 0, 39, 0, 0, 0, 18, 10, 67
"d:\Projects\truth-mesh\packages\core\src\interfaces\crypto.ts", "TypeScript", 0, 13, 0, 0, 0, 54, 9, 76
"d:\Projects\truth-mesh\packages\core\src\interfaces\index.ts", "TypeScript", 0, 3, 0, 0, 0, 9, 2, 14
"d:\Projects\truth-mesh\packages\core\src\interfaces\merkle.ts", "TypeScript", 0, 17, 0, 0, 0, 65, 10, 92
"d:\Projects\truth-mesh\packages\core\src\interfaces\storage.ts", "TypeScript", 0, 10, 0, 0, 0, 48, 9, 67
"d:\Projects\truth-mesh\packages\core\src\ipfs\helia-storage.ts", "TypeScript", 0, 99, 0, 0, 0, 62, 27, 188
"d:\Projects\truth-mesh\packages\core\src\ipfs\mock-storage.ts", "TypeScript", 0, 91, 0, 0, 0, 86, 27, 204
"d:\Projects\truth-mesh\packages\core\src\merkle\tree.ts", "TypeScript", 0, 130, 0, 0, 0, 70, 36, 236
"d:\Projects\truth-mesh\packages\core\src\truth-mesh.ts", "TypeScript", 0, 222, 0, 0, 0, 123, 54, 399
"d:\Projects\truth-mesh\packages\core\src\types\fact.ts", "TypeScript", 0, 26, 0, 0, 0, 45, 6, 77
"d:\Projects\truth-mesh\packages\core\src\types\index.ts", "TypeScript", 0, 21, 0, 0, 0, 12, 4, 37
"d:\Projects\truth-mesh\packages\core\src\types\proof.ts", "TypeScript", 0, 33, 0, 0, 0, 55, 7, 95
"d:\Projects\truth-mesh\packages\core\src\types\result.ts", "TypeScript", 0, 56, 0, 0, 0, 70, 13, 139
"d:\Projects\truth-mesh\packages\core\src\utils\errors.ts", "TypeScript", 0, 115, 0, 0, 0, 43, 39, 197
"d:\Projects\truth-mesh\packages\core\src\verification\verify.ts", "TypeScript", 0, 200, 0, 0, 0, 56, 29, 285
"d:\Projects\truth-mesh\packages\core\tests\crypto.test.ts", "TypeScript", 0, 152, 0, 0, 0, 9, 55, 216
"d:\Projects\truth-mesh\packages\core\tests\integration.test.ts", "TypeScript", 0, 269, 0, 0, 0, 22, 75, 366
"d:\Projects\truth-mesh\packages\core\tests\merkle.test.ts", "TypeScript", 0, 207, 0, 0, 0, 12, 60, 279
"d:\Projects\truth-mesh\packages\core\tests\storage.test.ts", "TypeScript", 0, 158, 0, 0, 0, 9, 59, 226
"d:\Projects\truth-mesh\packages\core\tsconfig.json", "JSON with Comments", 0, 0, 0, 0, 38, 6, 6, 50
"d:\Projects\truth-mesh\packages\core\vitest.config.ts", "TypeScript", 0, 30, 0, 0, 0, 6, 7, 43
"d:\Projects\truth-mesh\prototypes\README.md", "Markdown", 22, 0, 0, 0, 0, 0, 12, 34
"d:\Projects\truth-mesh\prototypes\ipfs-integration\PLAN.md", "Markdown", 342, 0, 0, 0, 0, 0, 104, 446
"d:\Projects\truth-mesh\prototypes\ipfs-integration\RESEARCH.md", "Markdown", 341, 0, 0, 0, 0, 0, 90, 431
"d:\Projects\truth-mesh\tsconfig.json", "JSON with Comments", 0, 0, 0, 0, 38, 6, 6, 50
"d:\Projects\truth-mesh\vitest.config.ts", "TypeScript", 0, 30, 0, 0, 0, 6, 7, 43
"Total", "-", 2797, 2345, 0, 10231, 76, 1101, 1653, 18203